0 0 0 0 0 0 0 0 0 0 0 0 0 0 0
0 3 0 3 0 0 0 0 0 0 0 0 3 0 0
0 0 0 3 3 3 3 3 3 3 3 3 3 0 0
0 0 3 3 7 7 7 7 7 7 7 7 3 0 0
0 0 3 7 7 7 7 7 7 7 7 7 3 0 0
0 0 3 7 7 7 7 7 7 7 7 7 3 0 0
0 0 3 7 7 1 7 2 7 7 7 7 3 0 0
0 0 3 3 3 3 3 3 3 3 3 3 3 0 0
0 3 0 0 0 0 0 0 0 0 0 0 0 0 0
0 0 0 0 0 0 0 0 0 0 0 0 0 0 0
